20 20
9 18
2 2 2 2 2 2 2 2 2 5 5 2 2 2 2 2 2 2 2 2
2 6 6 6 6 6 6 6 6 5 5 6 6 6 6 6 6 6 6 2
2 6 6 6 6 6 6 6 6 5 5 6 6 6 6 6 6 6 6 2
2 6 6 6 6 6 6 6 6 5 5 6 6 6 6 6 6 6 6 2
2 6 6 6 6 6 6 5 5 5 5 5 5 6 6 6 6 6 6 2
2 6 6 6 6 6 6 5 5 5 5 5 5 6 6 6 6 6 6 2
2 6 6 6 6 5 5 5 5 5 5 5 5 5 5 6 6 6 6 2
2 6 6 6 5 5 5 5 5 5 5 5 5 5 5 5 6 6 6 2
2 6 6 5 5 5 5 5 5 5 5 5 5 5 5 5 5 6 6 2
2 6 6 5 5 5 5 5 5 5 5 5 5 5 5 5 5 6 6 2
2 6 6 5 5 5 5 5 5 5 5 5 5 5 5 5 5 6 6 2
2 6 6 5 5 5 5 5 5 5 5 5 5 5 5 5 5 6 6 2
2 6 6 6 5 5 5 5 5 5 5 5 5 5 5 5 6 6 6 2
2 6 6 6 6 5 5 5 5 5 5 5 5 5 5 6 6 6 6 2
2 6 6 6 6 6 6 5 5 5 5 5 5 6 6 6 6 6 6 2
2 6 6 6 6 6 6 5 5 5 5 5 5 6 6 6 6 6 6 2
2 6 6 6 6 6 6 6 6 5 5 6 6 6 6 6 6 6 6 2
2 6 6 6 6 6 6 6 6 5 5 6 6 6 6 6 6 6 6 2
2 6 6 6 6 6 6 6 6 5 5 6 6 6 6 6 6 6 6 2
2 2 2 2 2 2 2 2 2 2 2 2 2 2 2 2 2 2 2 2